120 137 20 14
-3 -7 -7 0 0 0 -2 0 0 0 0 21 0 0 0 21 0 0 0 -9
-10 21 21 0 0 21 -2 21 0 0 21 0 -2 0 21 0 21 21 21 -2
21 21 -2 0 21 0 0 21 0 21 -2 0 0 21 0 0 21 0 0 -9
-10 0 0 0 0 0 -2 -2 0 0 0 -2 0 -2 0 0 21 21 21 -9
-10 0 22 0 21 21 0 0 0 21 0 21 0 0 0 0 0 0 0 -9
-10 0 23 0 21 0 21 21 21 21 0 21 21 0 21 21 0 0 0 -9
-10 0 0 0 0 0 21 0 0 0 0 0 21 0 21 0 0 0 0 -9
-10 -2 0 0 0 0 21 21 21 0 0 0 0 0 0 0 21 0 0 -9
-10 0 22 0 21 0 21 0 0 0 0 0 21 0 0 0 21 21 0 -9
-10 0 23 0 0 21 -2 21 21 0 0 0 21 21 -2 21 0 0 0 -9
21 0 -2 0 0 0 0 21 21 0 21 21 -2 0 0 0 0 0 0 -9
21 0 0 0 0 0 0 0 0 0 0 0 0 0 0 0 0 0 0 -9
-10 0 22 0 21 21 0 21 21 0 0 21 21 0 0 -2 21 21 0 -9
-5 -8 23 0 0 0 -2 0 0 0 0 0 0 0 0 0 0 -8 -8 -6