120 137 16 10
41 42 42 42 42 42 42 42 42 42 42 42 42 43 44 45 
46 3 3 3 3 3 3 3 3 3 3 3 3 52 51 50
46 3 0 0 0 0 0 0 0 0 0 0 0 52 53 0
46 3 0 2 0 2 0 2 0 2 0 2 0 52 53 0 
46 3 0 0 0 0 0 0 0 0 0 0 0 52 53 0 
46 3 0 0 0 0 0 0 0 0 0 0 0 52 53 0 
46 3 0 2 0 2 0 2 0 2 0 2 0 52 53 0 
46 3 0 0 0 0 0 0 0 0 0 0 0 52 53 0 
46 3 3 3 3 3 3 3 3 3 3 3 3 52 54 45
47 42 42 42 42 42 42 42 42 42 42 42 42 48 49 50

 