120 137 20 13
41 42 42 42 42 42 42 42 43 45 3 3 3 3 3 2 2 2 2 2 
46 3 3 0 0 0 3 3 52 53 0 0 0 0 0 2 2 2 2 2  
46 3 0 0 2 0 0 3 52 53 0 2 2 0 2 0 0 0 0 0 
46 0 0 2 0 2 0 0 52 53 0 0 0 0 2 0 2 2 0 0  
46 0 0 0 0 0 0 0 52 53 0 2 0 0 0 0 0 0 0 0  
46 0 0 2 0 2 0 0 52 53 0 2 0 0 0 2 0 2 0 0  
46 3 0 0 2 0 0 3 52 53 0 0 0 2 0 2 0 2 0 0  
46 3 3 0 0 0 3 3 52 53 0 2 2 2 0 0 0 0 0 0 
47 42 42 42 42 42 42 42 48 50 0 0 0 0 0 0 0 2 0 0 
0 0 0 0 0 0 0 0 0 0 0 2 0 2 2 0 2 2 2 0 
0 2 0 2 0 2 0 2 0 2 0 2 0 0 0 0 0 0 0 0 
0 2 0 2 0 2 0 2 0 2 0 0 0 0 2 0 2 2 0 0 
0 0 0 0 0 0 0 0 0 0 0 0 0 2 2 0 0 0 0 0 

