120 137 20 13
41 42 42 42 42 42 42 42 42 42 42 42 42 42 42 42 42 42 42 59 
46 3 3 0 0 0 3 3 52 53 3 3 3 3 2 2 2 2 2 46  
46 3 0 0 2 0 0 3 55 50 0 0 0 0 2 2 2 2 2 46 
46 0 0 2 0 2 0 0 0 0 0 0 0 2 0 0 0 0 0 46  
46 0 0 0 0 0 0 2 0 2 0 2 0 0 0 0 0 2 0 46  
46 0 0 2 0 2 0 0 0 0 0 0 0 2 0 2 0 0 0 46  
46 3 0 0 2 0 0 3 56 45 0 0 0 0 0 0 0 2 0 46  
46 3 3 0 0 0 3 3 52 53 0 2 0 2 0 2 0 2 0 46 
57 42 42 42 42 42 42 42 48 50 0 0 0 0 0 0 0 0 0 46 
46 0 0 0 0 0 0 0 0 0 0 0 3 0 3 0 3 0 3 46 
46 0 3 0 3 0 3 0 3 0 3 0 0 0 0 0 0 0 0 46 
46 0 0 0 0 0 0 0 0 0 0 0 3 0 3 0 3 0 0 46 
47 42 42 42 42 42 42 42 42 42 42 42 42 42 42 42 42 42 42 58  